#domain
hospital
#levelname
MAsoko3_08
#colors
blue: 0, 1, 2, 3, 4, 5, 6, 7, A
#initial
++++++++++
+0A      +
+1A      +
+2A      +
+3A      +
+4A      +
+5A      +
+6A      +
+7A      +
++++++++++
#goal
++++++++++
+       A+
+       A+
+       A+
+       A+
+       A+
+       A+
+       A+
+       A+
++++++++++
#end
